data14
14
-1 76 50 49 36 48 81 85 59 16 57  9 56 60
92 -1 76  1 91  4 37  5 39 47 47 60 72 30
80 21 -1 93 30  4 32 62  6 89 90 80 22 60
16  9  4 -1 88  6 31 12 87 83 50 62 96  4
21  2  2  8 -1  4 30 90  7 65  2 88 93 79
 3 84 37 67  9 -1 63 86 45 47 78 24 90 66
74 81 21 11  7 99 -1 75 31 36  5 11 20 64
87 91  4  5 91 79 67 -1 32 61 28 65 94 54
56 80 70  9 23 87 21 26 -1 83 86 30 78 27
46 90  8  2 57 13  8  8  3 -1 28 83 70 50
61 45 85 90 35 48 25 21 91 56 -1 17 80 91
97 75 48 62 20  6 31 89 19 42 18 -1 78 12
59 37 15 71 21 18 37 69 74 54 50 46 -1 97
 7  5 57 72 17 34 20 96 75 37  4 50 41 -1
