11
-1 33 10  8  9 35 59 30 72 78 24
65 -1 64 85 59 18 82 53 23 89 42
33 50 -1 92 22  4 88 72 67 23 52
83 65 21 -1  8 70 89 14 56 78 47
99 89 78  4 -1 19 37  5 31 45 57
13 58 73 53 37 -1 58  1 47 54 57
33 19 56 97 30 79 -1 15 45 25 81
42 68 25 24 49 77 27 -1 74 91 58
58 46 98 82 83 67 92 31 -1 67 57
79 12 62 92 25 15 83 27 97 -1 72
51 70 93 82 85  6 14 51 83 13 -1
