16
-1 49 11 43 91 66 45 52  7 51 30 22 35 50 99 51
 3 -1 65 66 21 91 25 77 21 46 93 87 19 58 66 46
93 51 -1 50 58  4 58 64 59 19 23 77 96 75 11  8
21 90 66 -1 94 34 92 93 95 27 10 98 82 46 60 86
 5 99 95 32 -1 11 85 47 16 70  5 13 62 97 88 46
66 25 61 64 29 -1 12 86 71  3 63 34 92 72 10 82
94 58 51 18 41 74 -1  8 37 11 27 66  9 41 89 95
24 49 34 80 59 42 58 -1 85 91 25 94 76 21 74 18
 3 90 16 66  3 84 53 83 -1  3  6 89 79 73 91 16
39 41 71 58 66 91 45  4 97 -1 68 66 76 65 20  8
77 54 70 11 77 24 90 79 66 36 -1 40 33 41 79 42
67 58 19 87 43  6 40  4 49 34 57 -1 98 74 13 34
16 10 26 77 12 30 91 68 81 80 21 78 -1 48  5 80
58 60 54  3  7 74 99 85 51  3 96 32 21 -1 96 24
79 40 18 40 57 50  6 82 31 57 73 62 68 34 -1 43
53 81 64 49 61 88 54 22 50 49 20  5 12  3 46 -1
