18
-1  3 43 76 54  9 62 60 16 91 21 36 96 11 94 70 75 64
40 -1 92 34 59 22 84 13 43 66 34 18 47 47 47 97 73 84
43 11 -1 58 79 38  2 40 52 16 22 83  8 26 94 67 97 71
72  8 13 -1 38 83  5 54 52  6 96 30 86 85  7 31 10 25
65 28 10 45 -1 95 26 76 77 38 45 81 74 12 63 27 73 85
52 20 47 52 88 -1 26 40 70 51 74 26 97 79 61 16 52 20
12 15 26 16 73 79 -1  7 89 77 66 15 64 57 23 15 59 50
18 25 23 69 52 48 46 -1 87 62 83 85  6 35 34 78 50 65
45 55 79 74 19 26 26 10 -1 37 85 79 40 11 58 23 89 10
71 19  9  9 55 73 24 52 64 -1 70 69 26 36  5 33 12 36
92 48  2 51 11 26 90 71 32 78 -1 83 89  3 41 42  5 33
10 25 30 53 26 37 90 10 41 40 34 -1 26 42 35 12 33 15
75 72 90 19 32 27 81 29 46 97 27 40 -1  3 55 91 87 68
32 20 65 18 97 94  5 83 21 37 98 70 91 -1 42 28 63  6
91 80 66 16  8 10  4 37  4 33 19 15 96 13 -1  9 32 37
25 23 78 22 51 62 59 30 93 18 47 80 73 79 74 -1 15 87
41 58 19 83 59 74 13 55 66 32 72 88 11  9 41 73 -1 25
86  6  4 76 20 75  4 26  9 36 71 38 13 31 94 56 41 -1
